32 32
100 400
2 2 2 2 2 2 2 2 2 2 2 2 2 2 2 2 2 2 2 2 2 2 2 2 2 2 2 2 2 2 2 2
2 0 0 0 0 0 0 0 0 0 0 0 2 3 0 4 2 2 2 3 0 0 0 0 0 0 2 3 4 2 0 2 
2 2 4 0 5 6 5 0 7 2 0 0 2 3 0 3 0 4 0 0 0 3 0 0 4 2 4 0 4 2 3 2
2 4 2 0 0 0 4 0 2 0 3 0 3 0 2 3 0 3 0 3 0 0 0 0 0 3 3 2 0 0 0 2
2 0 2 3 0 5 0 3 0 0 4 0 3 0 4 0 5 0 0 0 0 0 3 4 0 4 3 4 3 2 0 2
2 0 4 0 3 0 2 0 3 4 0 0 0 0 2 3 3 3 4 0 4 0 4 0 0 4 0 0 0 2 0 2
2 0 3 2 0 2 3 0 0 0 3 0 0 0 0 0 0 9 8 7 6 5 4 3 2 2 3 0 3 0 0 2
2 0 3 3 3 0 3 0 2 2 0 0 4 4 4 4 2 2 0 0 0 8 9 0 0 2 0 0 0 2 0 2
2 0 0 0 3 0 2 2 0 0 0 0 0 0 3 3 3 4 4 4 2 2 0 0 3 0 2 3 0 2 3 2
2 0 2 3 0 5 0 3 0 0 4 0 0 2 3 2 0 2 2 2 2 2 3 3 3 3 0 0 0 3 3 2
2 0 4 0 3 0 2 0 3 4 0 0 3 0 3 0 3 0 3 4 0 4 0 2 3 0 2 0 2 0 3 2
2 0 0 0 0 0 0 0 0 0 0 0 2 3 0 4 2 2 2 3 0 0 0 0 0 0 2 3 4 2 0 2
2 2 4 0 5 6 5 0 7 2 0 0 2 3 0 3 0 4 0 0 0 3 0 0 4 2 4 0 4 2 3 2
2 4 2 0 0 0 4 0 2 0 3 0 3 0 2 3 0 3 0 3 0 0 0 0 0 3 3 2 0 0 0 2
2 0 2 3 0 5 0 3 0 0 4 0 3 0 4 0 5 0 0 0 0 0 3 4 0 4 3 4 3 2 0 2
2 0 4 0 3 0 2 0 3 4 0 0 0 0 2 3 3 3 4 0 4 0 4 0 0 4 0 0 0 2 0 2
2 0 3 2 0 2 3 0 0 0 3 0 0 0 0 0 0 9 8 7 6 5 4 3 2 2 3 0 3 0 0 2
2 0 3 3 3 0 3 0 2 2 0 0 4 4 4 4 2 2 0 0 0 8 9 0 0 2 0 0 0 2 0 2
2 0 0 0 3 0 2 2 0 0 0 0 0 0 3 3 3 4 4 4 2 2 0 0 3 0 2 3 0 2 3 2
2 0 2 3 0 5 0 3 0 0 4 0 0 2 3 2 0 2 2 2 2 2 3 3 3 3 0 0 0 3 3 2
2 0 4 0 3 0 2 0 3 4 0 0 3 0 3 0 3 0 3 4 0 4 0 2 3 0 2 0 2 0 3 2
2 0 0 0 0 0 0 0 0 0 0 0 2 3 0 4 2 2 2 3 0 0 0 0 0 0 2 3 4 2 0 2 
2 2 4 0 5 6 5 0 7 2 0 0 2 3 0 3 0 4 0 0 0 3 0 0 4 2 4 0 4 2 3 2
2 4 2 0 0 0 4 0 2 0 3 0 3 0 2 3 0 3 0 3 0 0 0 0 0 3 3 2 0 0 0 2
2 0 2 3 0 5 0 3 0 0 4 0 3 0 4 0 5 0 0 0 0 0 3 4 0 4 3 4 3 2 0 2
2 0 4 0 3 0 2 0 3 4 0 0 0 0 2 3 3 3 4 0 4 0 4 0 0 4 0 0 0 2 0 2
2 0 3 2 0 2 3 0 0 0 3 0 0 0 0 0 0 9 8 7 6 5 4 3 2 2 3 0 3 0 0 2
2 0 3 3 3 0 3 0 2 2 0 0 4 4 4 4 2 2 0 0 0 8 9 0 0 2 0 0 0 2 0 2
2 0 0 0 3 0 2 2 0 0 0 0 0 0 3 3 3 4 4 4 2 2 0 0 3 0 2 3 0 2 3 2
2 0 2 3 0 5 0 3 0 0 4 0 0 2 3 2 0 2 2 2 2 2 3 3 3 3 0 0 0 3 3 2
2 0 4 0 3 0 2 0 3 4 0 0 3 0 3 0 3 0 3 4 0 4 0 2 3 0 2 0 2 0 3 2
2 2 2 2 2 2 2 2 2 2 2 2 2 2 2 2 2 2 2 2 2 2 2 2 2 2 2 2 2 2 2 2